NO ./textures/wall_bricks1.png
SO ./textures/wall_bricks1.png
WE ./textures/wall_bricks1.png
EA ./textures/wall_bricks1.png

F 220,100,0
C 225,30,0

11111111111111111
10000000001000001
100000000010000N1
10000000001000001
11111111111111111