NO ./textures/wall_bricks1.png
SO ./textures/wall_bricks1.png
WE ./textures/wall_bricks1.png
EA ./textures/wall_bricks1.png

F 220,100,0
C 225,30,0

1111111111111111111111111
1000000000110000000000001
1011000001110000000000001
1001000000000000000000001
11110001111000000000000001
10000000000000000111111111111
111101111N1111011100000010001
11110111111111011101010010001
11000011111111011100000010001
10000000000000001100000010001
10000000000000001101010000001
1100000111010101111101100000111
11110111 1110101 101111000001
11111111 1111111 111111111111