NO ./textures/greenwall.png
SO ./textures/greenwall2.png
WE ./textures/greenwall3.png
EA ./textures/mr_frog.png


C 225,30,0
F 220,100,0


1111
10S1
1001
11111


C 225,30,0
