NO ./textures/wall_bricks1.png
SO ./textures/wall_bricks1.png
WE ./textures/wall_bricks1.png
EA ./textures/wall_bricks1.png

F 220,100,0
C 225,30,0

        1111111111111111111111111
        1000000000110000000000001
        1011000001110000000000001
        1001000000000000000000001
111111111011000001110000000000001
100000000011000001110111111111111
11110110111111011100000010001
11110000111111011101010010001
11000000010101011100000010001
10000000000000001100000000001
10000000000000001101010000001
1100N001110101011111011100001
1111110011110101 101111010001
11111111 1111111 111111111111
