NO ./textures/wall_bricks1.png


SO ./textures/wall_bricks1.png
WE ./textures/wall_bricks1.png
EA ./textures/wall_bricks1.png


F 220,100,0
C 225,30,0

111111111111111111111111111111111111111111111111111111111111111111111111111
100000000000000000000000000000000000000000000000000000000000000000000000001
100000000000000000000000000000000000000000000000000000000000000000000000001
100000000000000000000000000000000000000000000000000000000000000000000000001
100000000000000000000000000000000000000000000000000000100000000000000000001
10000000000000000000000000000000000000000000000000000000000000000000000001
100000000000000000000000000000000000000000000000100000000000000000000000001
1000000000000000000000000000000000000000000000000000000000000000000000000011
100000000000000000000000000000000001111110000000000000000000000000000000000111
10000000000000000000000000000000111111100000000N000000000000000000000000000001
1000000000000000000000000000000111111011111100000000000000000000000000000000001
1000000000000000000000000000000001111111110000000000000000000000000000000001111
1000000000000000000000000000000000000000000000000000000000000000000000000011
100000000000000000000000000000000000000000000000000000000000000000000000001
100000000000000000000000000000000000000000000000000000000000000000000000001
100000000000000000000000000000000000000000000000000000000000000000000000001
100000000000000000000000000000000000000000000000000000000000000000000000001
100000000000000000000000000000000000000000000000000000000000000000000000001
100000000000000000000000000000000000000000000000000000000000000000000000001
111111111111111111111111111111111111111111111111111111111111111111111111111
