NO ./textures/wall_bricks1.png


SO ./textures/wall_bricks1.png
WE ./textures/wall_bricks1.png
EA ./textures/wall_bricks1.png


F 220,100,0
C 225,30,0


1111111111111111111111111111111111111111111111111111
1000000000000000000000100000000000000000000000000001
1000000000000000000010000000000000000000000000000001
1000000000000000000000000000000000000000000000000001
10000000000000000001101100000W0000000000000000000001
1000000000000000000000000000000000000000000000000001
1000000000000000000000000000000000000000000000000001
1000010000000000000000000000000000000000100000000001
1000010000000000000000000000000000000000000000000001
1000010000000000000000000000000000000000100000000001
1000000000000000000000000000000000000000000000000001
1000000000000000000000000000000000000000000000000001
1000000000000000000000000000000000000000000000000001
1000000000000000000101101000000000000000000000000001
1000000000000000000000000000000000000000000000000001
1000000000000000000000000000000000000000000000000001
1111111111111111111111111111111111111111111111111111
