NO ./textures/greenwall3.png
SO ./textures/greenwall2.png
WE ./textures/greenwall.png
EA ./textures/mr_frog.png



F 220,100,0
C 225,30,0


1111111111111111111111111111111111111111111111111111
1000000000000000000000100000000000000000000000000001
1000000000000000000010000000000000000000000000000001
1000000000000000000000000000000000000000000000000001
1000000000000000000110110000000000000000000000000001
1000000000000000000000000000000000000000000000000001
100000000000000000000000000000000000000000000000001
1000010000000000000000000000000000000000100000000001
1000010000000000000000000000000000000000000000000001
100001000000000000000N100000000000000000100000000001
1000000000000000000000000000000000000000000000000001
1000000000000000000000000000000000000000000000000001
1000000000000000000000000001000000000000000000000001
1000000000000000000101101000000000000000000000000001
1000000000000000000000000000000000000000000000000001
1000000000000000000010000000000000000000000000000001
1111111111111111111111111111111111111111111111111111
