NO ./textures/wall_bricks1.png
SO ./textures/wall_bricks1.png
WE ./textures/wall_bricks1.png
EA ./textures/wall_bricks1.png

F 220,100,0
C 225,30,0

11111111
10000001
10000001
10000001
100000011111111111
1000000000000000001
1000000000000000001
1111111111111100001
             100001
             100001
             100001
             100001
             100001
             10000111111111
             10000000000001
             10000000000001
             11111111100001
                     100001
111111111111111111111000001
100000000000000000000000001
1E0000000000000000000000001
100000000000000000000000001
111111111111111111111111111
