NO ./textures/greenwall.png
SO ./textures/greenwall2.png
WE ./textures/greenwall3.png
EA ./textures/mr_frog.png


F 220,100,0
C 225,30,0

111111111111111111111111111111111111111111111111111111111111111111111111111
100000000000000000000000000000000000000000000000000000000000000000000000001
100000000000000000000000000000000000000000000000000000000000000000000000001
100000000000000000000000000000000000000000000000000000000000000000000000001
100000000000000000000000000000000000000000000000000000100000000000000000001
100000000000000000000000000000000000000000000000000000000000000000000000011
10000000000000000000000000000000000000000000000010000000000000000000000000111
10000000000000000000000000000000000001000000000000000000000000000000000000111
100000000000000000000000000000000001111100000000000000000000000000000000001111
1000000000000000000000000000000011111001000000000000000000000000000000000000011
1000000000000000000000000000000111111000111100000000000000000000000000000000001
1000000000000000000000000000000001111000110000000000000000000000000000000001111
10000000000000000000000000000000000000000000000000000000000000000000000000111
100000000000000000000000000000000000000000000000000000000000000000000000011
100000000000000000000000000000000000000000000000000000000000000000000000001
100000000000000000000000000000000000000000000000000000000000000000000000011
1000000000000000000000000000000000000N0000000000000000000000000000000000001
100000000000000000000000000000000000000000000000000000000000000000000000001
100000000000000000000000000000000000000000000000000000000000000000000000001
111111111111111111111111111111111111111111111111111111111111111111111111111
